NO textures/simonkraft/wet_sponge.xpm
SO textures/simonkraft/wet_sponge.xpm
WE textures/simonkraft/wet_sponge.xpm
EA textures/simonkraft/wet_sponge.xpm

F 164,169,20
C 153,204,255

111111111111111111111
101000001000000000001
101010101011111110001
100010100010000010001
111110101111101011101
100000101000101000001
101111101011101111111111
10100000101011000101
101011111010111110101
101010001010100010101
10111010101010101010111
100000101010001010001
111111101011111011101
100000101000100010001
101110101110101110111
10100010000010001010111111
101011111111111010101
100010000000000010001
101010111011111111101
1N1000001000000000001
111111111111101111111